__T_T_____
T_______N_
___X______
______T_T_
T___T_____
_T____N___
_N_______T
___TT_____