TTTTTT___T
__TT__T___
__TT_____N
_T_N__N___
_T________
_T_X__N___
T____TT__T
T____T____