TTTTTT___T
__TT__T___
__TT_____X
_T_X__X___
_T____X___
_T_X__X___
T____TT__T
T____T____